10 10
....0.....
....0.....
00000.....
..........
..........
..........
..........
..........
..........
EEEEEEEEEE
0
