15 15
..*************
*.0....0..**0**
*********0*****
*********.*****
*********0*****
*******...*****
*******0*******
*******.*******
******.0*******
******.********
******0...0...*
*************..
**************.
**************0
**************E
0
7
sky wire.jpg 0
wall black-fence.jpg
exit exit.jpg
floor wood2.jpg
danger lava.jpg
hidden br-glass.jpg
moving metal.jpg
