15 15
..*.0***..*****
*.0....0....0**
****0....0.*.**
********.....**
********.0*..**
*******..******
*******0*******
*******..******
****....0******
****0..***..***
****..0...0...*
*************..
**************.
**************0
**************E
0
7
sky wire.jpg
wall lines.jpg
exit exit.jpg
floor stone.jpg
danger lava.jpg
hidden br-glass.jpg
moving metal.jpg
